algoritmo - algoritmo
fim_algoritmo - fim_algoritmo
declare - declare
literal - literal
inteiro - inteiro
real - real
logico - logico
leia - leia
escreva - escreva
se - se
entao - entao
senao - senao
fim_se - fim_se
caso - caso
seja - seja
fim_caso - fim_caso
tipo - tipo
para - para
ate - ate
faca - faca
fim_para - fim_para
enquanto - enquanto
fim_enquanto - fim_enquanto
procedimento - procedimento
fim_procedimento - fim_procedimento
funcao - funcao
fim_funcao - fim_funcao
ou - ou
e - e
nao - nao
registro - registro
fim_registro - fim_registro
var - var
constante - constante
verdadeiro - verdadeiro
falso - falso
retorne - retorne
